best song everï»¿| 	positive
goodï»¿| 	positive
honestly... this is pathetic.ï»¿| 	negative
boo heel turn asshole fuck you bitch motherfucker dumbassï»¿| 	negative
hey nicki. minaj i have a skimny but and fuck u!!!ï»¿| 	negative
love you nickiï»¿| 	positive
heal you are so disgusting nicki minaj how can you do thatï»¿| 	negative
1,030,077 great guys !  &lt;3ï»¿| 	negative
this makes me cryï»¿| 	positive
simply beautiful, perfection!ï»¿| 	positive
oh man, u made me shed tears....touch!!!ï»¿| 	positive
beautiful. just beautiful.ï»¿| 	positive
compelling lyrics... nice one!!!ï»¿| 	positive
im sold. fucking lovely.ï»¿| 	positive
love you. freaking amazing.ï»¿| 	positive
some assholes who have no brains disliked this song !!!!!!ï»¿| 	positive
niceï»¿| 	positive
i can&#39;t listen to this song without cryingï»¿| 	positive
it deserves more dislikesï»¿| 	negative
dafk is dis m8?ï»¿| 	negative
people were right. rebecca black&#39;s friday is shit.ï»¿| 	negative
girl, work! i love this song, don&#39;t worry about the haters! love you!ï»¿| 	positive
(â€¢_â€¢) this is so weird <br /> &lt;|&gt;<br />  /\ï»¿| 	negative
i feel like i now found a bitch!ï»¿| 	negative
this is the most annoying song in the worldï»¿| 	negative
the way you say friday is really disturbingï»¿| 	negative
this is the shittiest shit i have watched on the whole of youtubeï»¿| 	negative
i was 11 when this song was created now im 16 wow i still love itï»¿| 	positive
im surprised she still hasn&#39;t hung herself.ï»¿| 	negative
i just disliked because it&#39;s known to be disliked... :]ï»¿| 	negative
i cry at this video every single time. just beautifulï»¿| 	positive
its quite gross cuz his hands on my hair his clothes are in my room but love the songğŸ’–ğŸ’–ï»¿| 	positive
this reminds me of a lana del ray songï»¿| 	positive
oh Ä± love you taylor swift :)ï»¿| 	positive
epic !!!!ï»¿| 	positive
having a personal one to this song, nice touch labrinth bro xxï»¿| 	positive
amazing, amazing ğŸ˜ï»¿| 	positive
love it!ï»¿| 	positive
love itï»¿| 	positive
her voice is anoyingï»¿| 	negative
uglyï»¿| 	negative
if you have big butt what we could do dont shake your but you are giving me cancerï»¿| 	negative
ğŸ’ªğŸ’‹ğŸ‘ğŸ‘ğŸ‘ï»¿| 	positive
i feel so bad for drake lolz also at least better then jbï»¿| 	negative
free 1080p porn , i like it..ï»¿| 	positive
i would look at ur butt when u were at the gym nicki manajï»¿| 	positive
i don&#39;t no why i like this i watch it over and over againğŸ˜ğŸ˜ğŸ˜ğŸ˜ï»¿| 	positive
omg that laugh is giving me nightmares!ï»¿| 	negative
don&#39;t my anacondaï»¿| 	negative
stupid song mikiï»¿| 	negative
crazy song :)ï»¿| 	positive
this porn have iteresting musicï»¿| 	negative
this is what people are listening to now as &quot;rap&quot; music? sad.ï»¿| 	negative
this is our &quot;culture&quot;? omfg!ï»¿| 	negative
she fuck up this classic jam smh ğŸ˜³ğŸ‘.ï»¿| 	negative
what a crock of shiteï»¿| 	negative
lol :d<br />my anaconda&#39;s awake :-pï»¿| 	positive
i like your assï»¿| 	positive
too explicit xdï»¿| 	negative
you are with me..ï»¿| 	positive
i like you !ï»¿| 	positive
cuteï»¿| 	positive
i love this video!! <b><i>___</i></b>ï»¿| 	positive
i love this songï»¿| 	positive
:&#39;)<br />you make me cryï»¿| 	positive
this song makes me so emotional. breaks my heart.ï»¿| 	positive
i just wanna hug labrinth and tell him that everything&#39;s gonna be alright...ï»¿| 	positive
great ! i like this songï»¿| 	positive
but he looks super hot .i cant denyï»¿| 	positive
eyes ğŸ˜ğŸ˜ğŸ˜ğŸ˜ğŸ˜ğŸ˜ğŸ˜ğŸ˜ï»¿| 	positive
lo ame! ğŸ˜ï»¿| 	positive
what&#39;s sid from ice age doing there?ï»¿| 	positive
she is so sexy!ï»¿| 	positive
coolï»¿| 	positive
i don&#39;t even give a fuck any more i like justin&#39;s musicï»¿| 	positive
your songs suckï»¿| 	negative
awesome song! love you small peanut! :)ï»¿| 	positive
i&#39;m slapping the next kid i see with this haircutï»¿| 	negative
this song is okï»¿| 	positive
two lesbians making out is hawttt...keep it up justinï»¿| 	positive
gay lordï»¿| 	negative
he looks like miley cyrus with that hairstyle ğŸ˜‚ğŸ˜‚ğŸ˜‚ï»¿| 	negative
its like a sex tapeï»¿| 	positive
so very well sung justin bieber.  very talentedï»¿| 	positive
this stuff is hot menï»¿| 	positive
woah 1 mil likes!!??!??!?ï»¿| 	positive
ewwwwwwww is not good !!ï»¿| 	negative
i like it :)ï»¿| 	positive
amazin track in a timeï»¿| 	positive
im lovin it awsome song jb not a fan but now i amï»¿| 	positive
fuck my brother looks like that faggot fffffffuuuuuuuuuuccccccccckkkkkkkkkkï»¿| 	negative
shoot a canadian save a puppy !!ï»¿| 	negative
good songğŸ‘ğŸ»ï»¿| 	positive
this is great... everyone click on my channel and watch my adventure video also ğŸ˜ thumbs up pleaseï»¿| 	positive
how i wish i am that girl in the mv... =.= :)ï»¿| 	positive
i&#39;m not a justin beiber fan but i like this songï»¿| 	positive
amazingï»¿| 	positive
i love you justin bieberï»¿| 	positive
justin is still a faggotï»¿| 	negative
i love justin bieber, dead the deslikeï»¿| 	positive
â¤ï»¿| 	positive
