who else came here just to dislike the video?ï»¿| 	negative
the most disliked video in youtube. 5 million dislikes r.i.pï»¿| 	negative
this my shitğŸ’™ï»¿| 	positive
5 million dislike is bestï»¿| 	negative
5 million dislike is bestï»¿| 	negative
i came to dislike the video with my 3rd account.ï»¿| 	negative
first video i&#39;ve ever seen with more dislikes than likes ğŸ˜‚ğŸ˜‚ğŸ˜‚ğŸ˜‚ï»¿| 	negative
can we try to give him 5 200 000 likes and not 3 000 000 cause this shit isn t gamnam styleï»¿| 	positive
i still like this song even when ppl hates it lol i&#39;m so different from everyone else â˜ºï»¿| 	positive
that dislikesxdï»¿| 	negative
loveï»¿| 	positive
i hate it when people ask for likes.<br /><br />like if you agree.ï»¿| 	negative
one hit wonder, bieber will never hit 1b views again hahaï»¿| 	negative
im liking this just cause all you all hate itï»¿| 	positive
congrats on the 5 million dislikes guys :dï»¿| 	negative
ok wowï»¿| 	positive
he seriously looks younger than most 8 year oldsï»¿| 	negative
tf 5m unlikes ğŸ˜©ï»¿| 	negative
love this song...ï»¿| 	positive
why do people dislike this video?ï»¿| 	positive
why have none of my russian snipers picked this fucker off yet.ï»¿| 	negative
lets reach 6 million dislikes guys xdï»¿| 	negative
boooï»¿| 	negative
suck a dick justin bieberï»¿| 	negative
woh 5 million unlikesï»¿| 	negative
i came here just to dislike song :dï»¿| 	negative
5 mill dislikes hahaha xd most disliked video in the worldï»¿| 	negative
go justin bieber hart hartï»¿| 	positive
and ima huge baby baby baby oooohï»¿| 	negative
jb is son of yhe fucking bitch, i wanna fight with heï»¿| 	negative
jastin bieber te amoï»¿| 	positive
when she peeked out off the door she looked like cara delevigneï»¿| 	positive
i likeï»¿| 	positive
when she peeked out off the door she looked like cara delevigneï»¿| 	positive
i think hes hot and im not a fan but his music is getting better. what a good comeback justin :-)ï»¿| 	positive
i like justine bieber and selena gomez should be in that video :)<br />:) :)ï»¿| 	positive
not cool i&#39;m cry:&#39;(ï»¿| 	negative
stfu justing u and ur fukwit hair and hf dog u cuntï»¿| 	negative
he&#39;s ugly and gayï»¿| 	negative
she is either on her period of hitting puberty but nice song fluf the hatersï»¿| 	positive
the last two songs this guy made or been in have been really goodï»¿| 	positive
i dont liket this songï»¿| 	negative
so so good 3 &lt;3 &lt;3ï»¿| 	positive
she is sad cozof  his small dickï»¿| 	negative
this gay shit career is slowly dying fuck yeahh!!!!!!!!!ï»¿| 	negative
so sad, yet so beautiful <br /><br /> - via ytpak(.com)ï»¿| 	positive
no words to describe it but simply beautifulï»¿| 	positive
xfactor brought me here and stayinï»¿| 	positive
i just cnt stop listenin to it &lt;3 .. luv it so bad &lt;3ï»¿| 	positive
makes me cry every single time -and that&#39;s not always a bad thing .. thanx &lt;3ï»¿| 	positive
this guy is a phreakin legend. all i have to say..ï»¿| 	positive
he sounds like a chocking 5 year oldï»¿| 	negative
this song is the best thing that&#39;s ever happenedï»¿| 	positive
love &lt;3ï»¿| 	positive
love justin bieber forever &lt;3ï»¿| 	positive
i love it,  the emotion,  the passion, the truth in the words.  beautiful!ï»¿| 	positive
love thisÂ song labrinth, bring tears to my eyes every time i hear it.ï»¿| 	positive
these hot parts are always in  all songsï»¿| 	positive
i think right now is my favourite song.ï»¿| 	positive
beautiful. voice of an angel ğŸ˜ï»¿| 	positive
relatable...tearsï»¿| 	positive
to my beautiful baby sister up there in heaven...ï»¿| 	positive
lovely song i like itï»¿| 	positive
linda musica.ï»¿| 	positive
nick jonas brought me here. not regrettingï»¿| 	positive
amaziiiing!! fantastic!! roumanie!!ï»¿| 	positive
im 10 and when i saw this i felt like punching whole. through my computer like flappybirdï»¿| 	negative
we get it it&#39;s friday now shut upï»¿| 	negative
i love this song !!!â¤ï¸â¤ï¸ğŸ‘ŒğŸ¼ğŸ˜„âœ‹ğŸ»âœ‹ğŸ»ğŸ¶ğŸ‘ğŸ»ğŸ‘ğŸ»ğŸ‘ğŸ»ğŸ‘ğŸ»ğŸ’—ï»¿| 	positive
your very prettyï»¿| 	positive
this is awfu,l i mean awful<br />even the wordsï»¿| 	negative
this is sssoooo annoyingï»¿| 	negative
this bitch needs to litrerally dieï»¿| 	negative
these are the kinds of videos that gets schools shot upï»¿| 	negative
5 years later i&#39;m watching this and it&#39;s still shit.....ï»¿| 	negative
i hate how she says friday it&#39;s like fraiday fraiday i can fucking sing its freyevbcghjcnghfdayï»¿| 	negative
this is the most annoying song in the worldï»¿| 	negative
if her fridays are like this imagine her saturdays @__@ï»¿| 	negative
give me a hammer.ï»¿| 	negative
biggest fucking aids song ever you topped bieber mateï»¿| 	negative
