(â€¢_â€¢)<br /> (   )<br />that was the worst singing everï»¿| 	negative
why am i not watching porn?ï»¿| 	negative
this is so terrible kill urselfï»¿| 	negative
wtf did i just watch? now ill never get this fking song outa my ears, any solution?ï»¿| 	negative
niggewr god  dam songï»¿| 	positive
i don&#39;t mind the song it&#39;s funnyï»¿| 	positive
this song is very annoying and it sucks.ï»¿| 	negative
it&#39;s already been 4 years since this abomination was released huh? i feel old now.ï»¿| 	negative
so beautifulï»¿| 	positive
worst vid everï»¿| 	negative
these girls in the music video aint even prettyï»¿| 	negative
surprisingly her voice is the worst partï»¿| 	negative
waiting for bart to make a parody of this song...ï»¿| 	negative
taylor swift is really hotï»¿| 	positive
like a songï»¿| 	positive
like!!!!!!ï»¿| 	positive
love thisğŸ’˜ğŸ’˜ğŸ’˜ğŸ’˜ï»¿| 	positive
that is so sweet :d :d:dï»¿| 	positive
i liek dis sang!ï»¿| 	positive
i likeï»¿| 	positive
love you swiftï»¿| 	positive
good song! i love it! <b>-</b>ï»¿| 	positive
beautiful musicï»¿| 	positive
^^ï»¿| 	positive
itÂ´s not gay if it is in a 3 wayï»¿| 	positive
can&#39;t stop listening this song...ï»¿| 	positive
very perfectï»¿| 	positive
why is she holding her tummy is she pregnantï»¿| 	negative
love this songï»¿| 	positive
no matter how many times i watch this video, it just gets me everytime...ï»¿| 	positive
omg jutin please make a new song it been 2years we need a new song from u!ï»¿| 	positive
september 2015...  this song is a classic.  still make me cry ğŸ˜¢ï»¿| 	positive
nice songs justinï»¿| 	positive
when is so sadï»¿| 	negative
the bestğŸ˜ï»¿| 	positive
reminds me of my boyfriend every time i hear this ğŸ˜©ï»¿| 	negative
she is beautiful even her hair is black :)ï»¿| 	positive
she knows what every girl thinks.. god ..genius!ï»¿| 	positive
this sucksï»¿| 	negative
this is such a beautiful video!ï»¿| 	positive
this man looks like james dean, almost)ï»¿| 	positive
why the fuck am i here?ï»¿| 	negative
this song kills my earsï»¿| 	negative
love this songï»¿| 	positive
i luv those blue eyesï»¿| 	positive
trying to be halsey and lana so hardï»¿| 	negative
this is fantastic.....ï»¿| 	positive
this is really cheesyï»¿| 	negative
okay that was greatï»¿| 	positive
wow it&#39;s so prettyï»¿| 	positive
the song has a strong lana del rey feel.ï»¿| 	positive
:))))))))))))))ï»¿| 	positive
scott eastwood... what can you say but wowï»¿| 	positive
bullshitï»¿| 	negative
thanks you labrith. this song so touchingï»¿| 	positive
i have completely fallen in love with his voice, this song is amazing.ï»¿| 	positive
it&#39;s very emotional.ï»¿| 	positive
seriously too beautifulï»¿| 	positive
nice videoï»¿| 	positive
this is a very very very beautiful song.  i can&#39;t get enough of you.ï»¿| 	positive
this is exactly how i feel towards you ian. i love you and miss you so much baby boy. xxï»¿| 	positive
his voice and the lyrics are beautiful i&#39;m so glad i clicked the videoï»¿| 	positive
woow mate,you can put me think and cry ;( the best :d ï»¿| 	positive
labrinth deserves a grammy for this song its one of the most beautiful songs in the worldï»¿| 	positive
this is a beautiful song.. definitely remembering this one. &lt;3ï»¿| 	positive
i cried so hard hearing this song in xfactor loll, this is amazing.ï»¿| 	positive
this song is a punch in the heart i don&#39;t know why its not popular...ï»¿| 	negative
i love it!!! xxï»¿| 	positive
it makes me think of my baby sometimesï»¿| 	positive
xfactor made me do it after watching the boy i stay watching ğŸ˜ï»¿| 	positive
wauw its soo beautifullï»¿| 	positive
this sad song :(ï»¿| 	positive
amazingï»¿| 	positive
song gives me goosebumps.ï»¿| 	positive
love you labyrinth ï»¿| 	positive
amazing voice and song.ï»¿| 	positive
10 mill views only ??ï»¿| 	positive
josh daniel brought me here... this song will now forever be a different experience for meï»¿| 	positive
love this song !!!ï»¿| 	positive
a definite feels songï»¿| 	positive
published on halloween!!! btw i love this song! :3ï»¿| 	positive
i like itï»¿| 	positive
80% porn   10%swearing 10% music like wtfï»¿| 	negative
porn niceï»¿| 	positive
sexy :)ï»¿| 	positive
yassï»¿| 	positive
:   )ï»¿| 	positive
this is stupid ğŸ˜ï»¿| 	negative
sexyï»¿| 	positive
lolï»¿| 	negative
sexy.ï»¿| 	positive
bad move miley bad moveï»¿| 	negative
queenï»¿| 	positive
worst ever video clipï»¿| 	negative
how stupidï»¿| 	negative
i love youï»¿| 	positive
&lt;3ï»¿| 	positive
ughÂ <br /><b>slut!</b>ï»¿| 	negative
&lt;3 ^_^ï»¿| 	positive
i love herï»¿| 	positive
beautiful songï»¿| 	positive
ğŸ‘Œ perfecttï»¿| 	positive
song beautifulï»¿| 	positive
one of my favsï»¿| 	positive
shes uglyï»¿| 	negative
this never gets old to me ğŸ˜ğŸ˜ï»¿| 	positive
i love you music rihannaï»¿| 	positive
nice song....rihana you are so cuteï»¿| 	positive
badï»¿| 	negative
nice song about friendship.. :)ï»¿| 	positive
roll on still listening to u in 2015 every time it rains :-)ï»¿| 	positive
i love heeeeeeeeeerrrrrrrrrr &lt;3 shes so beautifulï»¿| 	positive
l love music &quot;umbrella &quot; ğŸ˜ï»¿| 	positive
old but gold song !ï»¿| 	positive
niceï»¿| 	positive
this video is perfect exept jay z :( :)ï»¿| 	positive
i hÃ¢te the songï»¿| 	negative
satan in Ã  youtubeï»¿| 	negative
